{
    "mapColumn": 31,
    "mapRow": 31,
    "mapWidth": 800,
    "mapHeight": 900,
    "tileSize": 96,
    "layers": [
      [
        [26, 1, 1, 1, 1, 1, 1, 1, 1, 1, 1, 1,1, 1, 1, 1, 1, 1, 1, 1, 1, 1, 1, 1, 1,1, 1, 1, 1, 1, 2],
        [7, 8, 8, 8, 8, 8, 8, 8, 8, 8, 8, 8,8, 8, 8, "doorTopDown", 8, 8, "doorTopDown2", 8, 8, 8, 8, 8, 8,8, 8, 8, 8, 8, 9],
        [7, 3, 3, 3, 3, 3, 3, 3, 3, 3, 3, 3,3, 3, 3, 99, 3, 3, 98, 3, 3, 3, 3, 3, 3,3, 3, 3, 3, 3, 9],
        [7, 3, 3, 3, 3, 3, 3, 3, 3, 3, 3, 3,3, 3, 3, 3, 3, 3, 3, 3, 3, 3, 3, 3, 3,3, 3, 3, 3, 3, 9],
        [7, 3, 3, 3, 3, 3, 3, 3, 3, 3, 3, 3,3, 3, 3, 3, 3, 3, 3, 3, 3, 3, 3, 3, 3,3, 3, 3, 3, 3, 9],
        [7, 3, 3, 3, 3, 3, 3, 3, 3, 3, 3, 3,3, 3, 3, 3, 3, 3, 3, 3, 3, 3, 3, 3, 3,3, 3, 3, 3, 3, 9],
        [7, 3, 3, 3, 3, 3, 3, 3, 3, 3, 3, 3,3, 3, 3, 3, 3, 3, 3, 3, 3, 3, 3, 3, 3,3, 3, 3, 3, 3, 9],
        [7, 3, 3, 3, 3, 3, 3, 20, 15, 15, 15, 15,15, 15, 15, 15, 15, 15, 15, 15, 15, 15, 15, 27, 3,3, 3, 3, 3, 3, 9],
        [7, 3, 3, 3, 3, 3, 3, 24, 22, 22, 22, 22,22, 22, 22, 22, 22, 22, 22, 22, 22, 22, 22, 25, 3,3, 3, 3, 3, 3, 9],
        [7, 3, 3, 3, 3, 3, 3, 9, 0, 0, 0, 0,0, 0, 0, 0, 0, 0, 0, 0, 0, 0, 0, 7, 3,3, 3, 3, 3, 3, 9],
        [7, 3, 3, 3, 3, 3, 3, 9, 0, 0, 0, 0,0, 0, 0, 0, 0, 0, 0, 0, 0, 0, 0, 7, 3,3, 3, 3, 3, 3, 9],
        [7, 3, 3, 3, 3, 3, 3, 9, 0, 0, 0, 0,0, 0, 0, 0, 0, 0, 0, 0, 0, 0, 0, 7, 3,3, 3, 3, 3, 3, 9],
        [7, 3, 3, 3, 3, 3, 3, 9, 0, 0, 0, 0,0, 0, 0, 0, 0, 0, 0, 0, 0, 0, 0, 7, 3,3, 3, 3, 3, 3, 9],
        [7, 3, 3, 3, 3, 3, 3, 9, 0, 0, 0, 0,0, 0, 0, 0, 0, 0, 0, 0, 0, 0, 0, 7, 3,3, 3, 3, 3, 3, 9],
        [7, 3, 3, 3, 3, 3, 3, 9, 0, 0, 0, 0,0, 0, 0, 0, 0, 0, 0, 0, 0, 0, 0, 7, 3,3, 3, 3, 3, 3, 9],
        [7, 3, 3, 3, 3, 3, 3, 9, 0, 0, 0, 0,0, 0, 0, 0, 0, 0, 0, 0, 0, 0, 0, 7, 3,3, 3, 3, 3, 3, 9],
        [7, 3, 3, 3, 3, 3, 3, 9, 0, 0, 0, 0,0, 0, 0, 0, 0, 0, 0, 0, 0, 0, 0, 7, 3,3, 3, 3, 3, 3, 9],
        [7, 3, 3, 3, 3, 3, 3, 9, 0, 0, 0, 0,0, 0, 0, 0, 0, 0, 0, 0, 0, 0, 0, 7, 3,3, 3, 3, 3, 3, 9],
        [7, 3, 3, 3, 3, 3, 3, 9, 0, 0, 0, 0,0, 0, 0, 0, 0, 0, 0, 0, 0, 0, 0, 7, 3,3, 3, 3, 3, 3, 9],
        [7, 3, 3, 3, 3, 3, 3, 9, 0, 0, 0, 0,0, 0, 0, 0, 0, 0, 0, 0, 0, 0, 0, 7, 3,3, 3, 3, 3, 3, 9],
        [7, 3, 3, 3, 3, 3, 3, 9, 0, 0, 0, 0,0, 0, 0, 0, 0, 0, 0, 0, 0, 0, 0, 7, 3,3, 3, 3, 3, 3, 9],
        [7, 3, 3, 3, 3, 3, 3, 9, 0, 0, 0, 0,0, 0, 0, 0, 0, 0, 0, 0, 0, 0, 0, 7, 3,3, 3, 3, 3, 3, 9],
        [7, 3, 3, 3, 3, 3, 3, 9, 0, 0, 0, 0,0, 0, 0, 0, 0, 0, 0, 0, 0, 0, 0, 7, 3,3, 3, 3, 3, 3, 9],
        [7, 3, 3, 3, 3, 3, 3, 15, 15, 15, 15, 15,15, 15, 15, 15, 15, 15, 15, 15, 15, 15, 15, 15, 3,3, 3, 3, 3, 3, 9],
        [7, 3, 3, 3, 3, 3, 3, 3, 3, 3, 3, 3,3, 3, 3, 3, 3, 3, 3, 3, 3, 3, 3, 3, 3,3, 3, 3, 3, 3, 9],
        [7, 3, 3, 3, 3, 3, 3, 3, 3, 3, 3, 3,3, 3, 3, 3, 3, 3, 3, 3, 3, 3, 3, 3, 3,3, 3, 3, 3, 3, 9],
        [7, 3, 3, 3, 3, 3, 3, 3, 3, 3, 3, 3,3, 3, 3, 3, 3, 3, 3, 3, 3, 3, 3, 3, 3,3, 3, 3, 3, 3, 9],
        [7, 3, 3, 3, 3, 3, 3, 3, 3, 3, 3, 3,3, 3, 3, 3, 3, 3, 3, 3, 3, 3, 3, 3, 3,3, 3, 3, 3, 3, 9],
        [7, 3, 3, 3, 3, 3, 3, 3, 3, 3, 3, 3,3, 3, 3, 3, 3, 3, 3, 3, 3, 3, 3, 3, 3,3, 3, 3, 3, 3, 9],
        [14, 15, 15, 15, 15, 15, 15, 15, 15, 15, 15, 15,15, 15, 15, 15, 15, 15, 15, 15, 15, 15, 15, 15, 15,15, 15, 15, 15, 15, 16],
        [21, 22, 22, 22, 22, 22, 22, 22, 22, 22, 22, 22,22, 22, 22, 22, 22, 22, 22, 22, 22, 22, 22, 22, 22,22, 22, 22, 22, 22, 23]
    ],
    [
      [0, 0, 0, 0, 0, 0, 0, 0, 0, 0, 0, 0,0, 0, 0, 0, 0, 0, 0, 0, 0, 0, 0, 0, 0,0, 0, 0, 0, 0, 0],
      [0, 31, 0, 0, 34, 0, 0, 32, 28, 35, 0, 0,34, 0, 31, 0, 0, 0, 0, 31, 34, 0, 0, 31, 0,0, 0, 0, 0, 0, 0],
      [0, 0, 0, 29, 0, 0, 30, 0, 0, 0, 0, 0,0, 0, 0, 0, 0, 0, 0, 29, 0, 0, 0, 0, 0,0, 0, 0, 0, 0, 0],
      [0, 0, 0, 0, 0, 0, 0, 0, 0, 0, 0, 0,0, 0, 0, 0, 0, 0, 0, 0, 0, 0, 0, 0, 0,0, 0, 0, 0, 0, 0],
      [0, 0, 0, 0, 0, 0, 0, 0, 0, 0, 0, 0,0, "coinBlue", 0, 0, 0, 0, 0, 0, 0, 0, 0, 0, 0,0, 0, 0, 0, 0, 0],
      [0, 0, 0, 0, 0, 0, 0, 0, 0, 0, 0, 0,0, 0, 0, 0, 0, 0, 0, 0, 0, 0, 0, 0, 0,0, 0, 0, 0, 0, 0],
      [0, 0, 0, 0, 0, 0, 0, 0, 0, 0, 0, 0,0, 0, 0, 0, 0, 0, 0, 0, 0, 0, 0, 0, 0,0, 0, 0, 0, 0, 0],
      [0, 0, 0, 0, 0, 0, 33, 0, 0, 0, 0, 0,0, 0, 0, 0, 0, 0, 0, 0, 0, 0, 0, 0, 0,0, 0, 0, 0, 0, 0],
      [0, 0, 0, 0, 0, 0, 0, 0, 0, 0, 0, 0,0, 0, 0, 0, 0, 0, 0, 0, 0, 0, 0, 0, 0,0, 0, 0, 0, 0, 0],
      [0, 0, 0, 0, 0, 0, 0, 0, 0, 0, 0, 0,0, 0, 0, 0, 0, 0, 0, 0, 0, 0, 0, 0, 0,0, 0, 0, 0, 29, 0],
      [0, 0, 0, 0, 0, 0, 0, 0, 0, 0, 0, 0,0, 0, 0, 0, 0, 0, 0, 0, 0, 0, 0, 0, 0,0, 0, 0, 0, 0, 0],
      [0, 0, 0, 0, 0, 0, 0, 0, 0, 0, 0, 0,0, 0, 0, 0, 0, 0, 0, 0, 0, 0, 0, 0, 0,0, 0, 0, 0, 0, 0],
      [0, 0, 0, 0, 0, 0, 0, 0, 0, 0, 0, 0,0, 0, 0, 0, 0, 0, 0, 0, 0, 0, 0, 0, 0,0, 0, 0, 0, 0, 0],
      [0, 0, 0, 0, 0, 0, 0, 0, 0, 0, 0, 0,0, 0, 0, 0, 0, 0, 0, 0, 0, 0, 0, 0, 0,0, 0, 0, 0, 0, 0],
      [0, 0, 0, 0, 0, 0, 0, 0, 0, 0, 0, 0,0, 0, 0, 0, 0, 0, 0, 0, 0, 0, 0, 0, 0,0, 0, 0, 0, 0, 0],
      [0, 0, 0, 0, 0, 0, 0, 0, 0, 0, 0, 0,0, 0, 0, 0, 0, 0, 0, 0, 0, 0, 0, 0, 0,0, 0, 0, 0, 0, 0],
      [0, 0, 0, 0, 0, 0, 0, 0, 0, 0, 0, 0,0, 0, 0, 0, 0, 0, 0, 0, 0, 0, 0, 0, 0,0, 0, 0, 29, 0, 0],
      [0, 0, 29, 0, "coinYellow", 0, 0, 0, 0, 0, 0, 0,0, 0, 0, 0, 0, 0, 0, 0, 0, 0, 0, 0, 0,0, 0, 0, 0, 0, 0],
      [0, 0, 0, 0, 0, 0, 0, 0, 0, 0, 0, 0,0, 0, 0, 0, 0, 0, 0, 0, 0, 0, 0, 0, 0,0, 0, 0, 0, 0, 0],
      [0, 0, 0, 0, 0, 0, 0, 0, 0, 0, 0, 0,0, 0, 0, 0, 0, 0, 0, 0, 0, 0, 0, 0, 0,0, 0, 0, 0, 0, 0],
      [0, 0, 0, 0, 0, 0, 0, 0, 0, 0, 0, 0,0, 0, 0, 0, 0, 0, 0, 0, 0, 0, 0, 0, 0,0, 0, 0, 0, 0, 0],
      [0, 0, 0, 0, 0, 0, 0, 0, 0, 0, 0, 0,0, 0, 0, 0, 0, 0, 0, 0, 0, 0, 0, 0, 0,0, 0, 0, 0, 0, 0],
      [0, 0, 0, 0, 0, 0, 0, 0, 0, 0, 0, 0,0, 0, 0, 0, 0, 0, 0, 0, 0, 0, 0, 0, 0,0, 0, 0, 0, 0, 0],
      [0, 0, 0, 0, 0, 0, 0, 0, 32, 0, 0, 0,0, 0, 32, 0, 0, 34, 0, 0, 0, 0, 32, 0, 0,0, 0, 0, 0, 0, 0],
      [0, 0, 0, 0, 0, 0, 0, 0, 30, 0, 0, 0,0, 0, 0, 0, 0, 0, 0, 0, 0, 0, 30, 0, 0,0, 0, 0, 0, 0, 0],
      [0, 0, 0, 0, 0, 0, 0, 0, 0, 0, 0, 0,0, 0, 0, 0, 0, 0, 0, 0, 0, 0, 0, 0, 0,0, 0, 0, 0, 0, 0],
      [0, 29, 0, 0, 0, 0, 0, 0, 0, 0, 0, 0,0, 0, 0, 0, 0, 0, 0, 0, 0, 0, 0, 0, "coinGreen",0, 0, 0, 0, 0, 0],
      [0, 0, 0, 0, 0, 0, 0, 0, 0, 0, 0, 0,0, 0, 0, 0, 0, 0, 0, 0, 0, 0, 0, 0, 0,0, 0, 0, 0, 0, 0],
      [0, 0, 0, 0, 0, 0, 0, 0, 0, 0, 0, 0,0, 0, 0, 0, 29, 0, 0, 0, 0, 0, 0, 0, 0,0, 0, 0, 0, 0, 0],
      [0, 0, 0, 0, 0, 0, 0, 0, 0, 0, 0, 0,0, 0, 0, 0, 0, 0, 0, 0, 0, 0, 0, 0, 0,0, 0, 0, 0, 0, 0],
      [0, 0, 0, 0, 0, 0, 0, 0, 0, 0, 0, 0,0, 0, 0, 0, 0, 0, 0, 0, 0, 0, 0, 0, 0,0, 0, 0, 0, 0, 0]
    ]
  ]
}